{
  "backgroundImagePath": "/img/Blue_Nebula_03-1024x1024.png",
  "tileSheetPath": "/img/Tileset_Adamatomic_Cavernas_8x8_edited.png",
  "originalTileWidth": 8,
  "originalTileHeight": 8,
  "displayTileWidth": 32,
  "displayTileHeight": 32,
  "map": [
    ["11,1", "000", "000", "000", "000", "000", "000", "000", "000", "000", "000", "000", "13,0", "000", "000", "000", "000", "000", "000", "000", "000", "000", "000", "000", "000", "000", "000", "9,1"],
    ["11,1", "000", "000", "000", "000", "000", "000", "000", "000", "000", "000", "000", "000", "000", "000", "000", "000", "000", "000", "000", "000", "000", "000", "000", "000", "000", "000", "9,1"],
    ["11,1", "000", "000", "000", "000", "000", "000", "000", "000", "000", "000", "000", "000", "000", "000", "000", "000", "000", "000", "000", "000", "000", "000", "000", "000", "000", "000", "9,1"],
    ["11,1", "000", "000", "000", "000", "000", "000", "000", "000", "000", "000", "000", "13,0", "000", "000", "000", "000", "000", "000", "000", "000", "000", "000", "000", "000", "000", "000", "9,1"],
    ["11,1", "000", "000", "000", "000", "000", "000", "000", "000", "000", "000", "000", "000", "000", "000", "000", "000", "000", "000", "000", "000", "000", "000", "000", "000", "000", "000", "9,1"],
    ["11,1", "000", "000", "000", "000", "000", "000", "000", "000", "000", "000", "000", "000", "000", "000", "000", "000", "000", "000", "000", "000", "000", "000", "000", "000", "000", "000", "9,1"],
    ["11,1", "000", "000", "000", "000", "000", "000", "000", "000", "000", "000", "000", "13,0", "000", "000", "000", "000", "000", "000", "000", "000", "000", "000", "000", "000", "000", "000", "9,1"],
    ["11,1", "000", "000", "000", "000", "000", "000", "000", "000", "000", "000", "000", "000", "000", "000", "000", "000", "000", "000", "000", "000", "000", "000", "000", "000", "000", "000", "9,1"],
    ["11,1", "000", "000", "000", "000", "000", "000", "000", "000", "000", "000", "000", "000", "000", "000", "000", "000", "000", "000", "000", "000", "000", "000", "000", "000", "000", "000", "9,1"],
    ["11,1", "000", "000", "000", "000", "000", "000", "000", "000", "000", "000", "000", "13,0", "000", "000", "000", "000", "000", "000", "000", "000", "000", "000", "000", "000", "000", "000", "9,1"],
    ["11,1", "000", "000", "000", "000", "000", "000", "000", "000", "000", "000", "000", "000", "000", "000", "000", "000", "000", "000", "000", "000", "000", "000", "000", "000", "000", "000", "9,1"],
    ["11,1", "000", "000", "000", "000", "000", "000", "000", "000", "000", "000", "000", "000", "000", "000", "000", "000", "000", "000", "000", "000", "000", "000", "000", "000", "000", "000", "9,1"],
    ["11,1", "000", "000", "000", "000", "000", "000", "000", "000", "000", "000", "000", "13,0", "000", "000", "000", "000", "000", "000", "000", "000", "000", "000", "000", "000", "000", "000", "9,1"],
    ["11,1", "000", "000", "000", "000", "000", "000", "000", "000", "000", "000", "000", "000", "000", "000", "000", "000", "000", "000", "000", "000", "000", "000", "000", "000", "000", "000", "9,1"],
    ["11,1", "000", "000", "000", "000", "000", "000", "000", "000", "000", "000", "000", "000", "000", "000", "000", "000", "000", "000", "000", "000", "000", "000", "000", "000", "000", "000", "9,1"],
    ["11,1", "000", "000", "000", "000", "000", "000", "000", "000", "000", "000", "000", "13,0", "000", "000", "000", "000", "000", "000", "000", "000", "000", "000", "000", "000", "000", "000", "9,1"],
    ["11,1", "000", "000", "000", "000", "000", "000", "000", "000", "000", "000", "000", "000", "000", "000", "000", "000", "000", "000", "000", "000", "000", "000", "000", "000", "000", "000", "9,1"],
    ["11,1", "000", "000", "000", "000", "000", "000", "000", "000", "000", "000", "000", "000", "000", "000", "000", "000", "000", "000", "000", "000", "000", "000", "000", "000", "000", "000", "9,1"],
    ["11,1", "000", "000", "000", "000", "000", "000", "000", "000", "000", "000", "000", "13,0", "000", "000", "000", "000", "000", "000", "000", "000", "000", "000", "000", "000", "000", "000", "9,1"],
    ["11,1", "000", "000", "000", "000", "000", "000", "000", "000", "000", "000", "000", "000", "000", "000", "000", "000", "000", "000", "000", "000", "000", "000", "000", "000", "000", "000", "9,1"],
    ["11,1", "000", "000", "000", "000", "000", "000", "000", "000", "000", "000", "000", "000", "000", "000", "000", "000", "000", "000", "000", "000", "000", "000", "000", "000", "000", "000", "9,1"],
    ["11,1", "000", "000", "000", "000", "000", "000", "000", "000", "000", "000", "000", "13,0", "000", "000", "000", "000", "000", "000", "000", "000", "000", "000", "000", "000", "000", "000", "9,1"],
    ["11,1", "000", "000", "000", "000", "000", "000", "000", "000", "000", "000", "000", "000", "000", "000", "000", "000", "000", "000", "000", "000", "000", "000", "000", "000", "000", "000", "9,1"],
    ["11,1", "000", "000", "000", "000", "000", "000", "000", "000", "000", "000", "000", "000", "000", "000", "000", "000", "000", "000", "000", "000", "000", "000", "000", "000", "000", "000", "9,1"],
    ["11,1", "000", "000", "000", "000", "000", "000", "000", "000", "000", "000", "000", "13,0", "000", "000", "000", "000", "000", "000", "000", "000", "000", "000", "000", "000", "000", "000", "9,1"],
    ["11,1", "000", "000", "000", "000", "000", "000", "000", "000", "000", "000", "000", "000", "000", "000", "000", "000", "000", "000", "000", "000", "000", "000", "000", "000", "000", "000", "9,1"],
    ["11,1", "000", "000", "000", "000", "000", "000", "000", "000", "000", "000", "000", "000", "000", "000", "000", "000", "000", "000", "000", "000", "000", "000", "000", "000", "000", "000", "9,1"],
    ["11,1", "000", "000", "000", "000", "000", "000", "000", "000", "000", "000", "000", "13,0", "000", "000", "000", "000", "000", "000", "000", "000", "000", "000", "000", "000", "000", "000", "9,1"],
    ["11,1", "000", "000", "000", "000", "000", "000", "000", "000", "000", "000", "000", "000", "000", "000", "000", "000", "000", "000", "000", "000", "000", "000", "000", "000", "000", "000", "9,1"],
    ["11,1", "000", "000", "000", "000", "000", "000", "000", "000", "000", "000", "000", "000", "000", "000", "000", "000", "000", "000", "000", "000", "000", "000", "000", "000", "000", "000", "9,1"],
    ["11,1", "8,0", "000", "7,0", "7,0", "7,0", "7,0", "7,0", "7,0", "7,0", "7,0", "7,0", "7,0", "7,0", "7,0", "7,0", "7,0", "7,0", "7,0", "7,0", "7,0", "7,0", "7,0", "7,0", "7,0", "7,0", "8,0", "9,1"],
    ["11,1", "8,2", "000", "7,2", "7,2", "7,2", "7,2", "7,2", "7,2", "7,2", "7,2", "7,2", "7,2", "7,2", "7,2", "7,2", "7,2", "7,2", "7,2", "7,2", "7,2", "7,2", "7,2", "7,2", "7,2", "7,2", "8,2", "9,1"],
    ["11,1", "000", "000", "000", "000", "000", "000", "000", "000", "000", "000", "000", "000", "000", "000", "000", "000", "000", "000", "000", "000", "000", "000", "000", "000", "000", "000", "9,1"],
    ["11,1", "000", "000", "4,0", "000", "000", "000", "000", "000", "000", "000", "000", "000", "000", "000", "000", "000", "000", "000", "000", "000", "000", "000", "000", "000", "000", "000", "9,1"],
    ["11,1", "000", "000", "000", "000", "000", "000", "000", "000", "000", "000", "000", "000", "000", "000", "000", "000", "000", "000", "000", "000", "000", "000", "000", "000", "4,0", "000", "9,1"],
    ["11,1", "000", "000", "000", "000", "000", "4,0", "000", "000", "000", "000", "000", "000", "000", "000", "000", "000", "000", "000", "000", "000", "4,0", "000", "000", "000", "000", "000", "9,1"],
    ["11,1", "000", "000", "000", "000", "000", "000", "000", "000", "000", "000", "000", "000", "000", "000", "000", "000", "000", "000", "000", "000", "000", "000", "000", "000", "000", "000", "9,1"],
    ["11,1", "000", "000", "000", "000", "000", "000", "000", "000", "4,0", "000", "000", "000", "000", "000", "000", "000", "000", "000", "000", "000", "000", "000", "000", "000", "000", "000", "9,1"],
    ["11,1", "000", "000", "000", "000", "000", "000", "000", "000", "000", "000", "000", "000", "000", "000", "000", "000", "4,0", "000", "000", "000", "000", "000", "000", "000", "4,0", "000", "9,1"],
    ["11,1", "000", "000", "000", "000", "000", "000", "000", "000", "000", "000", "4,0", "000", "000", "000", "000", "000", "000", "000", "000", "000", "000", "000", "000", "000", "000", "000", "9,1"],
    ["11,1", "000", "000", "000", "000", "000", "000", "000", "000", "000", "000", "000", "000", "000", "000", "000", "000", "000", "000", "000", "000", "000", "000", "000", "000", "000", "000", "9,1"],
    ["11,1", "000", "000", "000", "000", "000", "000", "000", "000", "000", "000", "000", "000", "4,0", "000", "000", "000", "000", "000", "000", "000", "000", "000", "000", "000", "4,0", "000", "9,1"],
    ["11,1", "000", "000", "000", "000", "000", "000", "000", "000", "000", "000", "000", "000", "000", "000", "000", "000", "000", "000", "000", "000", "000", "000", "000", "000", "000", "000", "9,1"],
    ["11,1", "000", "000", "000", "000", "000", "000", "000", "000", "000", "000", "000", "000", "000", "000", "000", "000", "000", "000", "000", "000", "000", "000", "000", "000", "000", "000", "9,1"],
    ["11,1", "000", "000", "000", "000", "000", "000", "000", "000", "000", "000", "000", "000", "000", "000", "000", "000", "000", "000", "000", "000", "000", "000", "000", "000", "4,0", "000", "9,1"],
    ["11,1", "000", "000", "000", "000", "000", "000", "000", "000", "000", "000", "000", "000", "000", "000", "000", "000", "000", "000", "000", "000", "000", "000", "000", "000", "000", "000", "9,1"],
    ["11,1", "000", "000", "000", "000", "000", "000", "000", "000", "000", "000", "000", "000", "000", "000", "000", "000", "000", "000", "000", "000", "000", "000", "000", "000", "000", "000", "9,1"],
    ["11,1", "000", "000", "000", "000", "000", "000", "000", "000", "000", "000", "000", "000", "000", "000", "000", "000", "000", "000", "000", "000", "000", "000", "000", "000", "4,0", "000", "9,1"],
    ["11,1", "000", "000", "000", "000", "000", "000", "000", "000", "000", "000", "000", "000", "000", "000", "000", "000", "000", "000", "000", "000", "000", "000", "000", "000", "000", "000", "9,1"],
    ["11,1", "000", "000", "000", "000", "000", "000", "000", "000", "000", "000", "000", "000", "000", "000", "000", "000", "000", "000", "000", "000", "000", "000", "000", "000", "000", "000", "9,1"],
    ["11,1", "3,0", "4,0", "4,0", "4,0", "4,0", "4,0", "4,0", "4,0", "4,0", "4,0", "4,0", "4,0", "4,0", "4,0", "4,0", "4,0", "4,0", "4,0", "4,0", "4,0", "4,0", "4,0", "4,0", "5,0", "000", "3,0", "9,1"],
    ["11,1", "3,2", "4,2", "4,2", "4,2", "4,2", "4,2", "4,2", "4,2", "4,2", "4,2", "4,2", "4,2", "4,2", "4,2", "4,2", "4,2", "4,2", "4,2", "4,2", "4,2", "4,2", "4,2", "4,2", "5,2", "000", "3,2", "9,1"],
    ["11,1", "000", "000", "000", "000", "000", "000", "000", "000", "000", "000", "000", "000", "000", "000", "000", "000", "000", "000", "000", "000", "000", "000", "000", "000", "000", "000", "9,1"],
    ["11,1", "000", "000", "000", "000", "000", "000", "000", "000", "000", "000", "000", "000", "000", "000", "000", "000", "000", "000", "000", "000", "000", "000", "000", "000", "1,0", "000", "9,1"],
    ["11,1", "000", "000", "000", "000", "000", "000", "000", "000", "000", "000", "000", "000", "000", "000", "000", "000", "000", "000", "000", "000", "000", "000", "000", "000", "000", "000", "9,1"],
    ["11,1", "000", "000", "000", "000", "000", "000", "000", "000", "000", "000", "000", "000", "000", "000", "000", "000", "000", "000", "000", "000", "1,0", "000", "000", "000", "000", "000", "9,1"],
    ["11,1", "000", "000", "000", "000", "1,0", "000", "000", "1,0", "000", "000", "000", "1,0", "000", "000", "000", "000", "1,0", "000", "000", "000", "000", "000", "000", "000", "000", "000", "9,1"],
    ["11,1", "000", "000", "000", "000", "000", "000", "000", "000", "000", "000", "000", "000", "000", "000", "000", "000", "000", "000", "000", "000", "000", "000", "000", "000", "000", "000", "9,1"],
    ["11,1", "000", "000", "000", "000", "000", "000", "000", "000", "000", "1,0", "000", "000", "000", "000", "000", "000", "000", "000", "0,0", "000", "000", "1,0", "2,0", "000", "000", "1,0", "9,1"],
    ["11,1", "000", "000", "1,0", "000", "000", "000", "000", "000", "000", "000", "000", "000", "000", "000", "000", "000", "000", "000", "000", "000", "000", "000", "000", "000", "000", "000", "9,1"],
    ["11,1", "000", "000", "000", "000", "000", "000", "000", "000", "000", "000", "000", "000", "000", "000", "000", "000", "000", "000", "000", "000", "000", "000", "000", "000", "000", "000", "9,1"],
    ["11,1", "000", "000", "000", "000", "0,0", "2,0", "000", "000", "000", "000", "000", "000", "000", "000", "000", "000", "000", "000", "000", "000", "000", "000", "000", "000", "1,0", "000", "9,1"],
    ["11,1", "000", "000", "000", "000", "000", "000", "000", "000", "000", "000", "000", "000", "000", "000", "000", "000", "000", "000", "000", "000", "000", "000", "000", "000", "000", "000", "9,1"],
    ["11,1", "000", "000", "000", "000", "000", "000", "000", "1,0", "000", "000", "000", "000", "000", "000", "000", "000", "000", "000", "000", "000", "000", "000", "000", "000", "000", "000", "9,1"],
    ["11,1", "000", "000", "000", "000", "000", "000", "000", "000", "000", "000", "000", "000", "000", "000", "000", "000", "000", "000", "000", "000", "000", "000", "000", "000", "000", "1,0", "9,1"],
    ["11,1", "000", "000", "000", "000", "000", "000", "000", "000", "000", "000", "000", "000", "000", "000", "000", "000", "000", "000", "000", "000", "000", "000", "000", "1,0", "000", "000", "9,1"],
    ["11,1", "000", "000", "000", "000", "000", "000", "000", "0,0", "1,0", "1,0", "2,0", "000", "0,0", "1,0", "2,0", "000", "000", "0,0", "1,0", "2,0", "000", "1,0", "000", "000", "000", "000", "9,1"],
    ["11,1", "000", "000", "000", "000", "000", "000", "0,0", "0,3", "1,1", "1,1", "2,1", "000", "0,2", "1,2", "2,2", "000", "000", "0,2", "1,2", "2,2", "000", "000", "000", "000", "000", "000", "9,1"],
    ["11,1", "000", "000", "0,0", "1,0", "2,0", "000", "0,2", "1,2", "1,2", "2,2", "000", "000", "000", "000", "000", "000", "000", "000", "000", "000", "000", "000", "000", "000", "000", "000", "9,1"],
    ["11,1", "17,2", "000", "000", "000", "000", "000", "000", "000", "000", "000", "000", "000", "000", "000", "000", "000", "000", "000", "000", "000", "000", "000", "000", "000", "000", "000", "9,1"],
    ["11,1", "0,0", "1,0", "1,0", "1,0", "1,0", "1,0", "1,0", "1,0", "1,0", "1,0", "1,0", "1,0", "1,0", "1,0", "1,0", "1,0", "1,0", "1,0", "1,0", "1,0", "1,0", "1,0", "1,0", "1,0", "1,0", "2,0", "9,1"],
    ["11,1", "0,1", "1,1", "1,1", "1,1", "1,1", "1,1", "1,1", "1,1", "1,1", "1,1", "1,1", "1,1", "1,1", "1,1", "1,1", "1,1", "1,1", "1,1", "1,1", "1,1", "1,1", "1,1", "1,1", "1,1", "1,1", "2,1", "9,1"],
    ["11,1", "0,1", "1,1", "1,1", "1,1", "1,1", "1,1", "1,1", "1,1", "1,1", "1,1", "1,1", "1,1", "1,1", "1,1", "1,1", "1,1", "1,1", "1,1", "1,1", "1,1", "1,1", "1,1", "1,1", "1,1", "1,1", "2,1", "9,1"]
  ]
}
