{
  "backgroundImagePath": "/img/Blue_Nebula_03-1024x1024.png",
  "tileSheetPath": "/img/Tileset_Adamatomic_Cavernas_8x8_reversed.png",
  "originalTileWidth": 8,
  "originalTileHeight": 8,
  "displayTileWidth": 32,
  "displayTileHeight": 32,
  "map": [
    ["000", "000", "000", "000", "000", "1,0", "000", "000", "000", "000", "000", "000", "000", "000", "000", "000", "000", "000", "000", "000", "000", "000", "000", "000", "000"],
    ["000", "000", "000", "000", "000", "000", "000", "000", "000", "000", "000", "000", "000", "000", "000", "000", "000", "000", "000", "000", "000", "000", "000", "000", "000"],
    ["000", "000", "000", "000", "000", "000", "000", "000", "000", "000", "000", "000", "000", "000", "000", "000", "000", "000", "000", "000", "000", "000", "000", "000", "000"],
    ["000", "000", "000", "000", "000", "000", "000", "000", "000", "000", "000", "000", "000", "000", "000", "000", "000", "000", "000", "000", "000", "000", "000", "000", "000"],
    ["000", "000", "000", "000", "000", "000", "000", "000", "000", "000", "000", "000", "000", "000", "000", "000", "000", "000", "000", "000", "000", "000", "000", "000", "000"],
    ["000", "000", "000", "000", "000", "000", "000", "000", "000", "000", "000", "000", "000", "000", "000", "000", "000", "000", "000", "000", "000", "000", "000", "000", "000"],
    ["000", "000", "000", "000", "000", "000", "000", "000", "000", "000", "000", "000", "000", "000", "000", "000", "000", "000", "000", "000", "000", "000", "000", "000", "000"],
    ["000", "000", "000", "000", "000", "000", "000", "000", "000", "000", "000", "000", "000", "000", "000", "000", "000", "000", "000", "000", "000", "000", "000", "000", "000"],
    ["000", "000", "000", "000", "000", "000", "000", "000", "000", "000", "000", "000", "000", "000", "000", "000", "000", "000", "000", "000", "000", "000", "000", "000", "000"],
    ["000", "000", "000", "000", "000", "000", "000", "000", "000", "000", "000", "000", "000", "000", "000", "000", "000", "000", "000", "000", "000", "000", "000", "000", "000"],
    ["000", "000", "000", "000", "000", "000", "000", "000", "000", "000", "000", "000", "000", "000", "000", "000", "000", "000", "000", "000", "000", "000", "000", "000", "000"],
    ["000", "000", "000", "000", "000", "0,3", "1,3", "2,3", "000", "0,2", "1,2", "2,2", "000", "000", "000", "000", "000", "000", "000", "000", "000", "000", "000", "000", "000"],
    ["000", "0,3", "1,3", "2,3", "000", "000", "000", "000", "000", "000", "000", "000", "000", "000", "000", "000", "000", "000", "000", "000", "000", "000", "000", "000", "000"],
    ["0,0", "1,0", "1,0", "1,0", "1,0", "1,0", "1,0", "1,0", "1,0", "1,0", "1,0", "1,0", "1,0", "1,0", "1,0", "1,0", "1,0", "1,0", "1,0", "1,0", "1,0", "1,0", "1,0", "1,0", "2,0"],
    ["0,1", "1,1", "1,1", "1,1", "1,1", "1,1", "1,1", "1,1", "1,1", "1,1", "1,1", "1,1", "1,1", "1,1", "1,1", "1,1", "1,1", "1,1", "1,1", "1,1", "1,1", "1,1", "1,1", "1,1", "2,1"],
    ["0,1", "1,1", "1,1", "1,1", "1,1", "1,1", "1,1", "1,1", "1,1", "1,1", "1,1", "1,1", "1,1", "1,1", "1,1", "1,1", "1,1", "1,1", "1,1", "1,1", "1,1", "1,1", "1,1", "1,1", "2,1"]
  ]
}
